###############
#S#   #       #
# # # # ##### #
#   #   #   # #
##### ### # # E
#     #   #   #
###############
